%#%%%%###%%#
%##%%%%#.%%#
%%%%.%#%%%%%
#..##%%%#%.#
r###...##%.#
e.e..#%%%%##
#.#.#%%##.##
#r#.##%%%.##
.e..e.%#%%%%
...######%%%
.#.#########
X.p#########
