p#r#.%%##..%
.#.#.%%##%%%
.e.###%%%%%%
#.###%#%####
#.##%%%%%%%#
#.%#%##%#%##
#.%%%.##%%%%
#.%%#..#..##
#####.#...e.
#..e.....#..
#r.#.###e#.p
#..e.#p..###
