####.#r.#.p#
%###..#.#..#
%#%%#%%%..##
%%#%%%##..##
#%#%%.####r#
%%#%#%e.r.e.
%%%%#%##..#.
%##%%%#pe.X.
%#%#####.##r
%%%.##...###
%#%#.##.####
%#%..#######
