##%%%#####%%
####%#%###%%
#%%#%#%%%#%.
#%#%%%%#%%%#
%%%%#%.##%##
#%##%%#%#%%%
%%%%%##%#%#%
%%##%##%%%##
.%##%#X#%%##
#ep##..#%###
#...e..#%###
######.#%%##
