###p#.......
r.#%..#.###X
..e%##..rr##
##.%%%%###.p
p#%%%#......
%###%%#.##e#
%%%%%%#.#..#
%###%%%....#
r#%%%%..##.#
##%####.##..
#%%#..e.##.r
####r.######
