p#r...###r.#
.##...p#...#
.....%#%...r
#..##%%%#%%#
r###%%%##%%#
e.%%%#%%%%##
#.#%#p%##%##
#r#%##..%%##
.e.%e.r#%%.r
...######%%%
.#.#########
X.p#########
