%#%#.p.##...
%#%#...##..r
%%%###.e....
#%###%#%####
#%##%%%%%%r#
#%%#%##%#%##
#%%%%%##...X
#%%%#%%#..##
#####%#...e.
#..e.....#..
#r.#.###e#.p
#..e.#p..###
