.p#.#%%##%##
..#%%%%%%%##
.##%%##%%%##
.%%%#r.%%%##
e#.###.##%%#
.r###p.p#%%#
.r#..#.##%%#
#.#..##r%%##
#..%%%%%%%.r
..e#..%%#%.#
.#...#####.#
e..r...X##.p
