##%%%#####.%
####%#%###.%
#%%#%#%%%#%%
#%#%%%%#%%%#
%%%%#%%##%##
#%##%%#%#%%%
%%%%%##%#%#%
%%##%##%%%##
.%##%#%#%%##
#%%##%%#%###
#.%%%%.#%###
######.#%%##
