%#%%%%###r.#
%##%%%p#...#
%%%%.%#....r
#%.##%%.#..#
r###..%##e.#
e.e..#%%%%##
#.#.#%%##%##
#r#.##%%%%##
.e..%%%#%%%%
...######%%%
.#.#########
X.p#########
