p#r#.p.##...
.#.#...##..r
.e.###.e....
#.###r#.####
#%##%...e.r#
#%%#%##r#e##
#%%%%%##...X
#%%%#%%#..##
#####%#.%.e.
#..e.%%%%#..
#r.#.###%#.p
#..e.#p..###
