p#r#.p.##...
.#.#...##..r
.e.###.e....
#.###r#.####
#.##....e.r#
#%%#%##r#e##
#%%%%%##%%%%
#%%%#%%#%%##
#####%#%%.e.
#..e.%%%%#..
#r.#.###e#.p
#..e.#p..###
