####.#r.#.p#
%###..#.#..#
%#..#.....##
%%#...##..##
#%#...####r#
%%#%#.e.r.e.
%%%%#.##..#.
%##%%p#pe.X.
%#r#####.##r
%%%%##...###
e#%#.##.####
p#%%%#######
