p#r...###%%#
.##...p#%%%#
.....e#.%%%r
#..##...#%%#
r###...##%%#
e.e..#%%%%##
#.#.#%%##%##
#%#%##%%%%##
%%%%%%%#%%%%
%%%######%%%
%#.#########
%.p#########
