%%%#%##e...#
#%##%#..#pp#
#%%%%%%..###
....##%.####
....##%##%##
r##.##%.#%%%
#%###%%..#%%
.%%###%%%%%#
##%%%%%##.%%
###%#####.%%
##%%%%%#%#%#
%%%#..##%%%#
