%%%#%##%%%%#
#%##%#%%#%%#
#%%%%%%%.###
%%%%##%%####
%%%%##%##r##
r##%##%%#...
#e###%%%%#e.
...###pe...#
##r...e##..r
###.#####...
##.e..p#X#e#
r..#..##...#
