####.#r.#.p#
r###..#.#..#
.#..#.....##
..#...##..##
#.#%%%####r#
..#%#%%%%.e.
%%%%#.##%%#.
%##.ep#pe%%.
%#%#####.##r
%%%.##...###
%#%#.##.####
%#%..#######
