.%%#%##e...#
#%##%#..#pp#
#%%%%%%..###
....##%.####
....##%##r##
r##.##%.#...
#e###%%%.#e.
...###%%%%.#
##%%%%%##%%r
###%#####.%.
##%%%%%#%#%#
%%%#%%##%%%#
