p#r...###%.#
.##...p#%%.#
.....e#%%%%%
#..##.%%#%.#
r###..%##%.#
e.e..#%%%%##
#.#.#p%##%##
#r#.##%%%%##
.%%%%%%#%%%r
.%%######%%.
.#.#########
X.p#########
