p#r...###r.#
.##...p#...#
.....e#....r
#..##...#..#
%###...##e.#
%%e..#....##
#%#.#pe##.##
#%#.##%%%.##
%%%%%%%#%%%%
%..######%..
%#.#########
%.p#########
