p..%##.....#
###%...###.r
%%%%####p.e#
%%##r#r###..
%##..#.#.##.
%%##...#....
%#r##..e.#e#
%%%%#.###..#
#%#%%%#..r.#
%%%%%##...##
%%##%###.#X.
##p.%#r....#
