%######%%#.%
%#..%%%%%#.%
%#%%%.#%##.%
%#%####%%#.%
%%%...##%#%%
%#......%%%.
%########%##
%#%%%#p.#%p#
%#%%%#..#%.#
%##%###e##.#
%%%%#%#....#
###%%%e.####
