%%#%#%%##.##
%%#%%%%%..##
%##..##%..##
%...#%%%%%##
%#.###%##%.#
%%###%%%#%.#
%%#..#.##%.#
#%#..##%%%##
#%%%%%%%%%%%
..%#....#.%#
.#%..#####%#
%%%%%%%%##%%
