%%%%##.....#
###%%%.###.r
%%%%####p.e#
%%##r#r###..
%##..#.#.##.
%%##...#....
%#r##..e.#e#
%%%%#.###..#
#%#e..#..r.#
.%...##...##
p.##.###.#X.
##p..#r....#
