p..e##.....#
###....###.r
.r..####p.e#
%%##r#%###..
%##..#%#.##.
%.##.%%#....
%#%##%%%.#e#
%%%%#%###..#
#%#%%%#..r.#
.e.%%##...##
p.##.###.#X.
##p..#r....#
