.%%#%##e...#
#%##%#..#pp#
#%.%%%%..###
%%%%##%.####
%...##%##r##
%##.##%.#...
#%###%%..#e.
%%%###%e...#
##%%%%%##..r
###%#####...
##%%%%%#X#e#
%%%#.%##...#
