##%%%#####%%
####%#%###%%
#%%#%#%%%#%%
#%#%%%%#%%%#
%%%%#..##%##
#%##..#p#%%%
%%%%%##%#%#%
%%##%##%%%##
..##%#X#%%##
#ep##..#%###
#...e..#%###
######.#%%##
