#%%%%%%#####
p#%%####....
..%%#p##.##X
#.#%%%#..#r.
###%#%#.##.#
##%%%%%%##e#
p%%#%%.#...r
#%%##%%#%..r
##%###%%%#.#
#r###.%###p#
..#.e.######
.....#######
