##%%%#####.p
####%#%###..
#.r#%#%%%#..
#e#.%%%#%%.#
p...#%%##%##
#e##%%#p#%%%
....%##e#%#%
r.##%##..%##
..##%#X#%%##
#ep##..#%###
#...e..#%###
######.#%%##
