#%%%%%%#####
p#%%####....
.%%%#%##.##X
#.#%%%#..#r.
###.#%#.##.#
##%%%%e.##e#
%%%#%%.#...r
#%%##..#e..r
##%###...#.#
#r###..###p#
..#.e.######
.....#######
