p#r...###%%#
.##...p#%%%#
.....e#%%%%%
#..##.%%#%%#
r###..%##%%#
e.e..#%%%%##
#.#.#p%##%##
#r#.##..%%##
.e..e.r#%%%%
...######%%%
.#.#########
X.p#########
