#%%%%.r#####
p#%%####....
..%%#p##.##X
#.#%%.#..#r.
###%#.#.##.#
##.%%%%.##e#
pe.#%%.#...r
#..##..#e..r
##r###...#.#
#r###..###p#
..#.e.######
.....#######
