###p#.......
r.#r..#.###X
..e.##..rr##
##.%%%%###.p
p#.%%#%%....
e###%p#.##e#
%%%%%%#.#..#
%###%%%....#
r#%%%%..##.#
##%####.##..
#%%#..e.##.r
####r.######
