###%#%%%%%%%
%%#%%%#%###%
%%%%##%%%%##
##..%%%###.p
p#..%#......
%###%%#.##e#
%%%%%.#.#..#
%###%......#
%#%%%...##.#
##%####.##..
#%%#..e.##.r
####r.######
