%%#.#%%##%##
%%#%%%%%%%##
%##%%##%%%##
%%%%#%%%%%##
%#.###%##%%#
%%###%%p#..#
%%#..#%##..#
#%#..##r..##
#%.e.....e.r
..e#....#..#
.#...#####.#
e..r...X##.p
