.%%#%##e...#
#%##%#..#pp#
#%.%%%%..###
%%%%##%.####
%...##%##r##
%##.##%%#...
#e###%%%.#e.
...###%%%%.#
##%%%%%##%%%
###%#####.%%
##%%%%%#%#%#
%%%#.%##%%%#
