%%%#%##%...#
#%##%#%%#pp#
#%%%%%%%.###
%%%%##%.####
%%%%##%##r##
%##.##%%#%%%
#e###re%%#%%
...###p%%%%#
##r...e##%%%
###.#####.%%
##.e..p#X#e#
r..#..##...#
