p..%##.....#
###%%..###.r
%%%%####p.e#
%%##r#r###..
%##..#.#.##.
%%##...#....
%#r##..e.#e#
%%..#.###..#
#%#%..#..r.#
.%%%%##...##
p.##.###.#X.
##p..#r....#
