#####%%#####
####.#%####%
##%#%%%%%%#%
##%#%#..#%%%
##%%%#.....%
##p.#%%%%%%%
r###%%#%###%
..##%###eX##
..r#%%%%%###
##..e###e###
#pe.####r###
##....######
