#####%%#####
####%#%####r
##%#%%%%%%#r
##%#%#%%#%..
##%%%#%%....
##p.#%%.....
r###%%#r###p
..##%###eX##
..r#%%...###
##..%###e###
#pe.####r###
##....######
