#%%.e.r#####
%#%%####....
%%%%#p##.##X
#%#%%%#..#r.
###%#%#.##.#
##.%%%e.##e#
pe.#%%%#...r
#..##%%#%..r
##r###%%%#.#
#r###%%###p#
%%#%%%######
.%%%.#######
