.p#.#%%##.##
..#r%%%...##
.##%%##...##
%%%%#r.e..##
%#%###.##%%#
%%###p.p#%%#
%%#..#.##%%#
#%#..##%%%##
#%.e%%%%%%.r
%%e#%%%%#%.#
%#..%#####.#
%%%%%..X##.p
