%#%%%%###%%#
%##%%%%#%%%#
%%%%%%#%%%%%
#..##%%%#..#
r###%%%##e.#
e%%%%#%...##
#%#.#%%##.##
#%#.##%%%.##
%%..e.%#%%.%
%..######%%%
%#.#########
%.p#########
