#####%%#####
####.#%####%
##%#%%%%%%#%
##%#%#%%#%%%
##%%%#%%...%
##%%#%%%%%%%
%###%%#%###%
%%##%###eX##
%%%#%%%%%###
##%%%###%###
#%%%####r###
##....######
