#%%%%%%#####
%#%%####....
%%%%#p##.##X
#%#%..#..#r.
###%#.#.##.#
##%%%.e.##e#
p%%#%..#...r
#%%##..#e..r
##r###...#.#
#r###..###p#
..#.e.######
.....#######
