p..e##.....#
###....###.r
.r..####p.e#
%.##%#%###..
%##.%#%#.##.
%.##%%%#%%%.
%#%##%%%%#%#
%%%%#%###..#
#.#%%%#..r.#
.%%%%##...##
%%##%###.#X.
##%%%#r....#
