%p#%#%%##.##
%.#%%%%...##
%##%%##...##
%%%%#r.e..##
%#%###.##e.#
%r###p.p#..#
%%#..#.##..#
#%#.%##%%.##
#%%%%%%%%e.r
%%%#%%%%#..#
%#%%%#####.#
%.%r...X##.p
