.p#.#%%##.##
..#r.%%%%%##
.##..##.%%##
....#r.%%%##
e#.###.##%%#
.r###p.p#%%#
.r#..#.##%%#
#.#..##%%%##
#..e..%%.%.r
..e#..%%#..#
.#...#####.#
e..r...X##.p
