r######.r#%%
.#....%%.#%%
.#....#%##%%
e#e####%%#%%
......##%#%%
r#....%%%%%%
.########%##
.#r.r#p.#%%#
.#...#..#%.#
r##e###e##.#
....#X#....#
###...e.####
