r######%%#%%
.#.....%.#%.
.#....#%##%.
e#e####%%#%.
......##%#%.
r#......%%%.
.########%##
.#r.r#%%#%%#
.#...#%%#%%#
r##e###%##%#
....#%#%%%%#
###..%%%####
