##%%%#####%%
####%#%###%.
#.r#%#%%%#%.
#e#%%%%#%%%#
%%%%#%.##%##
#%##%%#%#%%%
%%%%%##%#%#%
%%##%##%%%##
..##%#X#%%##
#ep##..#%###
#...e..#%###
######.#%%##
