#####%%#####
####.#%####%
##%#%%%%%%#%
##%#%#..#%%%
##%%%#..%%.%
##p.#%%%%%%%
%###%%#%###%
%%##%###%%##
%%%#%%%%%###
##%%%###e###
#%%%####r###
##....######
