#####r.#####
####%#e####r
##%#%%%%%p#r
##%#%#%%#...
##%%%#.%%%..
##%%#...%%..
r###e.#r###p
..##.###eX##
..r#.....###
##..e###e###
#pe.####r###
##....######
