#####%%#####
####.#%####%
##%#%%%%%%#%
##%#%#%.#%%%
##%%%#%%.%%.
##p.#%%%%%..
r###%%#%###p
..##%###%X##
..r#%%%%%###
##..e###e###
#pe.####r###
##....######
