r######.r#%%
.#.......#%.
.#....#e##%.
%#%####pp#%%
%%%%%%##%#%%
%#%%%%%%%%%%
%########%##
.#r.r#p.#%p#
.#...#..#%.#
r##e###e##.#
....#X#....#
###...e.####
