#%%.e.r#####
p#%.####....
..%%#p##.##%
#.#%..#..#%%
###%#.#.##%#
##%%%%%.##%#
%%%#..%#..%%
#%%##.%#%%%%
##%###%%%#%#
#r###..###%#
..#.e.######
.....#######
