p#r...###%%#
.##...p#%%%#
.....e#.%%%r
#..##%..#%%#
r###.%%##%%#
e.e..#%%%%##
#.#.#pe##%##
#r#.##.%%%##
.e..e.r#%%%%
...######%%%
.#.#########
X.p#########
