r######.%#%%
.#...%%%%#%%
.#%%%%#%##%.
e#%####%%#%.
%%%...##%#%.
%#......%%%.
%########%##
%#r.r#p.#%p#
%#...#..#%.#
%##e###e##.#
%%%%#%#....#
###%%%e.####
