.%%#%##%%%%#
#%##%#%%#%%#
#%%%%%%%%###
....##%%####
....##%##r##
r##.##%.#...
#%###%%..#e.
%%%###%e...#
##%%%%%##..r
###%#####...
##%%%%%#X#e#
%%%#%%##...#
