p#r#.p.##...
.#.#...##..r
.%.###.e....
#%###%#.####
#%##%%%%%%%#
#%%#%##%#e##
#%%%%%##...X
#%%%#%%#..##
#####%#...e.
#..e.....#..
#r.#.###e#.p
#..e.#p..###
