####.#r.#.p#
%###..#.#..#
%#..#.....##
%%#...##..##
#%#%%%####r#
%%#%#%%.r.e.
%%%%#%##..#.
%##.%%#pe.X.
%#%#####.##r
%%%.##...###
%#%#.##.####
%#%..#######
