###%#%%%....
%.#%%%#%###X
%%%%##%%%%##
##.%.%%###%%
p#.%%#%%%%%%
e###%%#.##%#
...e.%#.#.%#
e###.%....%#
r#%%%%%%##%#
##%####%##%%
#%%#%%%%##.%
####%%######
