#####%%#####
####%#%####%
##%#%%%%%%#%
##%#%#%.#%%%
##%%%#%....%
##%%#%%%%%%%
%###%%#%###%
%%##%###eX##
%%%#%%%%%###
##%%%###%###
#%%%####%###
##%%%%######
