##%%%#####%%
####%#%###%.
#%%#%#%%%#%.
#%#%%%%#%%%#
%%%%#%.##%##
#%##%%#p#%%%
%%%%%##e#%#%
%%##%##..%##
.%##%#%#%%##
#%%##%%#%###
#.%%%%.#%###
######.#%%##
