##%%%#####.p
####%#%###..
#.r#%#%%%#..
#e#%%%%#%%.#
%%%%#%.##%##
#e##%%#p#%%%
%%%%%##e#%#%
%%##%##..%##
..##%#X#%%##
#ep##..#%###
#...e..#%###
######.#%%##
