####.#r.#.p#
r###..#.#..#
.#..#.....##
..#...##..##
#.#...####r#
%.#.#%%%%%%.
%%%%#%##..#.
%##%%%#pe.X.
%#%#####.##r
%%%%##...###
%#%#%##.####
%#%%%#######
