%#r...###r.#
%##.%%%#...#
%%%%%%#....r
#%%##%%%#..#
r###..%##e.#
e.e..#%%%.##
#.#.#p%##%##
#r#.##%%%%##
.e..e.r#%%%%
...######%%%
.#.#########
X.p#########
