p..e##.....#
###....###.r
.%..####p.e#
%%##%#%###..
%##%%#%#.##.
%%##%%%#....
%#%##%%%.#e#
%%%%#%###..#
#%#%%%#..r.#
%%%%%##...##
%%##.###.#X.
##p..#r....#
