####.#r.#.p#
r###..#.#..#
.#..#.....##
..#.%.##..##
#%#%%%####r#
%%#%#%%.r.e.
%%%%#%##..#.
%##%%%#pe.X.
%#%#####.##r
%%%%##...###
%#%#%##.####
%#%%%#######
