p..e##.....#
###....###.r
.r..####p.e#
%.##%#%###..
%##.%#%#.##.
%.##%%%#%%%.
%#%##%%%%#%#
%%%%#%###%%#
#.#%%%#..%.#
.%%%%##.%%##
%%##%###%#%.
##%%%#%%%%%#
