###%#%%%%%%%
%%#%.%#%###%
%%%%##%%%%##
##%%%%%###.p
p#%%%#......
e###%%#.##e#
...e%.#.#..#
e###%......#
r#%%%...##.#
##%####.##..
#%%#..e.##.r
####r.######
