p#r...###r.#
.##...p#...#
.....e#....r
#..##...#.%#
r###%%.##%%#
e%%%%#%.%%##
#%#%#%%##%##
#%#%##%%%%##
.%%%%%%#%%%%
%%%######%%%
.#%#########
X.p#########
