p#%%%%###%.#
.##%%%p#%%%#
..%%%%#%%%%%
#..##%%%#%%#
r###%%%##%%#
e.e..#%%.%##
#.#.#p%##%##
#r#.##.%%%##
.e..e.r#%%%r
...######%..
.#.#########
X.p#########
