##r..#####.p
####.#%###..
#.r#.#%%%#..
#e#.e%%#%%.#
p...#%.##%##
#e##%%#%#%%.
.%%%%##%#%#r
r%##.##%%%##
.%##r#X#%%##
#ep##..#%###
#...e..#%###
######.#%%##
