###%#%%%%%%%
%.#%%%#%###%
%%%%##%%%%##
##.%%%%###.%
%#..%#%%%%%%
%###%%#%##%#
%%%%%.#%#..#
%###%%.%%%%#
%#%%%%%%##%#
##%####%##%%
#%%#%%%%##%%
####%%######
