#####r.#####
####%#e####r
##%#%%%.ep#r
##%#%#%.#...
##%%%#%.....
##%%#%%%....
r###%%#r###p
..##.###eX##
..r#.....###
##..e###e###
#pe.####r###
##....######
