%#r#.p.##...
%#.#...##..r
%%%###.e....
#%###r#.####
#%##....e.r#
#%%#.##r#e##
#%%%%%##%%.X
#%%r#%.#%%##
#####%#%%%%%
#..e.%%%%#%%
#r.#.###%#%%
#..e.#p..###
