###p#.%%....
r.#r..#%###X
..e.##%%%r##
##..%%%###%%
p#...#%%%%%%
e###.p#%##%#
...e..#%#..#
e###%%%%...#
r#%%%%%%##.#
##%####%##..
#%%#..e%##.r
####r.######
