p..e##.....#
###....###.r
%%..####p.e#
%%##r#%###..
%##..#%#.##.
%.##.%%#....
%#r##%%%.#e#
%%.%#%###..#
#%#%%%#..r.#
.%%%%##...##
p%##%###.#X.
##%%%#r....#
