##r..#####.p
####.#%###..
#%%#%#%%%#..
#%#%%%%#%%.#
%%%%#%%##%##
#%##.%#%#%%.
.....##%#%#r
r.##.##%%%##
..##r#X#%r##
#ep##..#%###
#...e..#%###
######.#%%##
