.p#.#%%##%##
..#r.%%%%%##
.##..##%%%##
....#%%%%%##
e#.###%##%.#
.r###%%%#%.#
.r#..#%##%.#
#.#..##%%%##
#..e%%%%%%.r
.%%#%%%%#..#
.#%%%#####.#
e%%%%..X##.p
