#%%.e.r#####
p#%.####....
..%%#%##.##X
#.#%.%#..#r.
###%#%#.##.#
##%%%%%.##%#
%%%#..%#..%%
#.%##.%#%%%%
##%###%%%#%#
#r###..###%#
..#.e.######
.....#######
