.%%#%##e...#
#%##%#..#pp#
#%%%%%%..###
....##%.####
....##%##%##
r##.##%.#%%.
#e###%%..#%.
...###%%%%%#
##r...%##%%%
###.#####.%.
##.e..p#%#%#
r..#..##%%%#
