#####%%#####
####.#%####%
##%#%%%%%%#%
##%#%#..#%%%
##%%%#.%%%%%
##p.#%%%....
%###%%#%###p
%%##%###%%##
%%%#%%%%%###
##%%%###e###
#%%%####r###
##....######
