p#r#.p.##...
.#.#...##..r
.e.###.e....
#.###%#.####
#.##%%%%e.r#
#%%#%##%#e##
#%.%%%##...X
#%%%#%%#..##
#####%#...e.
#%%%%%...#..
#r%#.###e#.p
#%%%%#p..###
