#%%%%%%#####
p#.%####....
..e%#%##.##%
#.#%%%#..#%%
###%#.#.##%#
##%%%%%.##%#
%%%#..%#%%%%
#.%##.%#%..%
##%###%%%#.#
#r###..###p#
..#.e.######
.....#######
