p#r...###r.#
.##...p#...#
.....e#....r
#..##...#..#
r###..%##%%#
e.e..#%%.%##
#.#%#%%##%##
#r#%##%%%%##
.e%%%%%#%%%%
%%%######%%%
.#.#########
X.p#########
