p#r...###r%#
.##...p#%%%#
.....e#%%%%%
#..##.%%#%.#
r###...##%%#
e.e..#...%##
#.#.#pe##%##
#r#.##%%%%##
.e..e.r#%%%%
...######%%%
.#.#########
X.p#########
