#####%%#####
####.#%####%
##%#%%%%%%#%
##%#%#..#%%%
##%%%#.....%
##%%#%%%%%%%
%###%%#%###%
%%##%###%%##
%%%#%%%%%###
##%%%###e###
#%%%####r###
##....######
