##r..#####.p
####.#r###..
#.r#.#...#..
#e#.e..#...#
p...#..##%##
#e##..#p#%%%
.....##%#%#%
r.##.##%%%##
..##r#X#%%##
#ep##..#%###
#...e..#%###
######.#%%##
