r######%%#.%
.#...%%%.#.%
.#%%%%#%##.%
e#%####%%#.%
%%%...##%#.%
%#%.....%%%%
%########%##
%#%%%#p.#%%#
%#%%%#..#%%#
%##%###e##.#
%%%%#%#....#
###%%%e.####
