#####%%#####
####.#%####%
##%#%%%%%%#%
##%#%#..#%%%
##%%%#..%%..
##p.#%%%%...
%###%%#%###p
%%##%###eX##
%%%#%....###
##%%%###e###
#pe.####r###
##....######
