##r..#####.p
####.#%###..
#.r#.#%%%#..
#e#%%%%#%%.#
%%%%#..##%##
#%##..#p#%%%
%%%%%##e#%#%
%%##%##..%##
..##%#X#%%##
#ep##..#%###
#...e..#%###
######.#%%##
