#%%%%%%#####
p#.%####%%%%
..e%#%##%##%
#.#%%%#%%#r.
###%#%#%##.#
##.e.%%%##e#
pe.#..%#...r
#..##..#e..r
##r###...#.#
#r###..###p#
..#.e.######
.....#######
