%%%%##%%%%%#
###%%%%###%%
%%%%####%%%#
%%##r#r###%%
%##..#.#.##%
%%##...#..%%
%#r##..e.#%#
%e..#.###%%#
#.#e..#%%%.#
.e...##%%.##
p.##.###%#%.
##p..#r%%%%#
