p%%%##%%%%%#
###%%%%###%%
%%%%####p%%#
%%##r#r###%%
%##..#.#.##%
e.##...#.%%%
.#r##..e.#%#
.e..#.###%%#
#.#e..#.%%%#
.e...##..%##
p.##.###.#X.
##p..#r....#
