r######%%#.%
.#%%%%%%%#%%
.#%...#%##%.
e#%####%%#%.
%%%...##%#%.
%#......%%%.
%########%##
%#r.r#p.#%%#
%#...#..#%%#
%##e###e##.#
%%%%#%#....#
###%%%e.####
