%%#.#%%##.##
%%#%%%%%..##
%##%%##%..##
%...#%%%%%##
%#.###%##%.#
%%###%%%#%%#
%%#..#.##%%#
#%#..##%%%##
#%.e.%.%%%%%
.%%#%%%%#.%#
.#%%%#####%#
e..%%%%%##%%
