p..e##%%%%%#
###%%%%###%%
%%%%####p.e#
%%##%#%###..
%##.%#%#.##.
%.##%%%#....
%#%##%.e.#e#
%%%%#%###..#
#.#%%%#..r.#
.e.%%##...##
p.##.###.#X.
##p..#r....#
