###p#.......
r.#r..#.###X
..e.##..rr##
##....e###%%
%#...#.%%%%%
%###%%#%##%#
%%%%%%#%#..#
%###%%%%...#
%#%%%%%%##.#
##%####.##..
#%%#..e.##.r
####r.######
