#####%%#####
####.#%####%
##%#%%%%%%#%
##%#%#..#%%%
##%%%#..%%..
##p.#%%%%...
%###%%#%###p
%%##%###%X##
%%%#%%%%%###
##%%%###e###
#pe.####r###
##....######
