%#%%%.###%%#
%##%%%%#.%%#
%%%%%%#%%%%%
#..##%%%#.%#
%###%%%##%%#
%%%%%#...%##
#%#.#pe##%##
#%#.##..%%##
.%..e.r#.%%%
%%.######%%.
%#.#########
%.p#########
