###p#.%%%%%%
r.#r..#%###%
..e.##%%%%##
##...%%###%%
p#...#%%%%%%
e###.p#.##%#
...e..#.#%%#
e###...%%%%#
r#%%%%%%##%#
##%####%##%%
#%%#%%%%##%%
####%%######
