.%%#%##%%..#
#%##%#.%#pp#
#%%%%%%%%###
....##%%####
....##%##r##
r##.##%.#...
#e###r%%.#e.
..%###%%%..#
##%%%%%##..r
###%#####...
##%%%%%#X#e#
r..#%%##...#
