.p#%#%%##.##
..#%%%%%..##
.##..##%..##
....#%%%%%##
e#.###%##%.#
.r###%%%#%.#
.r#..#%##%%#
#.#..##%%%##
#..e.%%%%%%%
..e#%%..#%%#
.#.%%#####%#
e..%%%%%##%%
