%%%#%##e...#
#%##%#%%#pp#
#%%%%%%%%###
.%%%##%%####
%%%%##%##r##
%##%##%%#...
#e###r%%%#e.
...###%%%%.#
##r.%%%##%%r
###.#####...
##.e..p#X#e#
r..#..##...#
