##%%%#####%%
####%#%###%%
#.r#%#%%%#%.
#e#%%%%#%%%#
p...#%%##%##
#e##%%#%#%%%
....%##%#%#%
r.##%##%%%##
..##%#X#%%##
#ep##..#%###
#...e..#%###
######.#%%##
