#####r.#####
####.#e####r
##%#....ep#r
##%#%#..#...
##%%%#......
##%%#.......
r###e.#r###p
..##.###eX##
..r#.....###
##..e###e###
#pe.####r###
##....######
