#####%%#####
####.#%####%
##%#%%%%%%#%
##%#%#%.#%%%
##%%%#%....%
##%%#%%%%%%%
%###%%#%###%
%%##%###eX##
.%%#%....###
##%%%###e###
#pe.####r###
##....######
