###p#.......
r.#r..#.###X
..%%##..rr##
##%%%%%###.p
%#%%%#......
%###%%#.##e#
%%%%%%#.#..#
%###%%%%...#
%#%%%%%%##.#
##%####%##..
#%%#..%%##.r
####r.######
