%%#.#%%##.##
%%#%%%....##
%##%.##...##
%%%%#r.e..##
%#.###.##e.#
%%###p.p#..#
%%#..#.##..#
#%#..##r..##
#%%e.....e.r
..%#....#..#
.#%..#####.#
e.%%%%%%##.p
