p#r...###%.#
.##...p#%%.#
.....e#%%%.r
#..##%%%#..#
r###%%%##e.#
e.%%%#%.%%##
#.#%#p%##%##
#r#%##%%%%##
.e.%%%%#%%%%
...######%%%
.#.#########
X.p#########
