#%%.e.r#####
p#%.####....
..%%#%##.##X
#.#%.%#..#r.
###%#%#.##.#
##%%%%%.##e#
%%%#..%#...r
#%%##.%#%..r
##%###%%%#.#
#r###..###p#
..#.e.######
.....#######
