#%%%e.r#####
p#.%####....
..e%#%##.##X
#.#%%%#..#r.
###%#%#.##.#
##%%%%%.##e#
%%%#%%%#...r
#%%##%%#e..r
##%###%..#.#
#r###..###p#
..#.e.######
.....#######
