##r..#####.p
####%#%###..
#.r#%#%%%#..
#e#%%%%#%%%#
p.%%#%.##%##
#e##..#p#%%%
.....##e#%#%
r.##.##%%%##
..##r#X#%%##
#ep##..#%###
#...e..#%###
######.#%%##
