###%#%%%%%%%
%%#%%%#%###%
.%%%##.%%%##
##%%..e###.p
%#.%%#......
%###%%#.##e#
%%%%%%#.#..#
%###%%.....#
%#%%%...##.#
##%####.##..
#%%#..e.##.r
####r.######
