%######%%#.%
%#%%%%%%%#.%
%#%...#%##.%
%#%####%%#.%
%%%...##%#%%
%#......%%%.
%########%##
%#%%%#p.#%p#
%#.%%#..#%.#
%##%###e##.#
%%%%#%#....#
###%%%e.####
