##r..#####%%
####.#r###%%
#.r#.#%%%#%%
#e#.e..#%%%#
p...#..##%##
#e##..#p#%%.
.....##%#%#r
r.##.##%%%##
..##r#X#%%##
#ep##..#%###
#...e..#%###
######.#%%##
