r######.r#%%
.#.......#%%
.#....#e##%%
%#%####pp#%%
%%%%%%##%#%%
%#.%%%%%%%%%
%########%##
%#r.r#p.#%%#
.#...#..#%%#
r##e###e##%#
....#X#...%#
###...e.####
