%%#.#%%##.##
%%#r%%....##
%##%%##...##
%%%%#r.e..##
%#%###.##e.#
%%###p.p#..#
%%#..#.##..#
#%#..##r..##
#%.e.....e.r
..e#....#..#
.#...#####.#
e..r...X##.p
