r######.r#%%
.#.......#%%
.#....#e##%%
e#e####pp#%%
......##%#%%
r#......%%%%
.########%##
.#r.r#%%#%%#
.#...#%%#%%#
r##e###%##%#
....#X#%%%%#
###...e.####
