.p#.#%%##%##
..#r.%%%%%##
.##..##%%%##
....#%%%%%##
e#.###%##%%#
.r###p.p#%%#
.r#..#.##%%#
#.#..##r%%##
#..e....%%.r
..e#....#..#
.#...#####.#
e..r...X##.p
