%%#%#%%##%##
%%#%%%%%%%##
%##%%##.%%##
%%%%#%%%%%##
%#.###%##e.#
%r###%%%#..#
.r#..#%##..#
#.#..##r..##
#..e.....e.r
..e#....#..#
.#...#####.#
e..r...X##.p
