#####%%#####
####.#%####%
##%#%%%%%%#%
##%#%#..#%%%
##%%%#..%%..
##p.#%%%%...
%###%%#%###p
%%##%###%X##
.%%#%%%%%###
##%%%###%###
#%%%####%###
##....######
