p..e##%%%%%#
###%%%%###%%
%%%%####p.e#
%%##%#%###..
%##.%#%#.##.
%.##%%%#....
%#%##%%%.#e#
%%%%#%###..#
#.#%%%#..r.#
.e...##...##
p.##.###.#X.
##p..#r....#
