%%%#%##e...#
#%##%#..#pp#
#%.%%%%..###
%%%%##%.####
%%..##%##r##
%##.##%.#...
#%###%%%%#e.
%%%###%%%..#
##%%%%%##..r
###%#####...
##%%%%%#X#e#
%%%#.%##...#
