p..e##.....#
###....###.r
.r..####p.e#
%.##%#%###..
%##.%#%#.##.
%.##%%%#....
%#%##%%%.#e#
%%%%#%###..#
#.#%%%#..r.#
.e...##...##
p.##.###.#X.
##p..#r....#
