###p#%%%%%%%
r.#r..#%###%
..e%##%%%r##
##.%%%%###%%
p#...#%%%%%%
e###.p#%##%#
...e..#%#.%#
e###%..%...#
r#%%%%%%##.#
##%####.##..
#%%#..e.##.r
####r.######
