%%%#r##e...#
#%##.#..#pp#
#%%%%%%..###
%%%%##%.####
%%%%##%##r##
%##%##%%#...
#e###r%%.#e.
...###%%...#
##r%%%%##..r
###%#####...
##%%%.p#X#e#
%%%#..##...#
