%%%#r##e...#
#%##.#..#pp#
#%%%%%%%.###
%%%%##%%####
%%%%##%##r##
r##%##%%#..%
#e###r%%%#%%
...###pe%%%#
##r...e##%%%
###.#####%%%
##.e..p#X#%#
r..#..##.%%#
