p..e##%%%%%#
###%%%%###%%
.%%%####p.e#
%%##%#%###..
%##.%#%#.##.
%.##%%%#....
%#%##%.e.#e#
%%%%#%###..#
#%#%%%#..r.#
%%%%.##...##
%.##.###.#X.
##p..#r....#
