#%%.e.r#####
p#%.####%%%%
..%%#p##%##%
#.#%..#%%#r.
###%#.#%##.#
##%%%%%%##e#
%%%#...#...r
#%%##..#e..r
##%###...#.#
#r###..###p#
..#.e.######
.....#######
