##r..#####.p
####.#r###..
#.r#.#...#..
#e#.e..#...#
p...#..##%##
#e##..#%#%%.
.....##%#%#r
r.##.##%%%##
..##r#X#%%##
#ep##..#%###
#...e..#%###
######.#%%##
