####.#r.#.p#
r###..#.#..#
.#..#.....##
..#...##..##
#.#%%%####%#
..#%#%%%%%%%
%%%%#%##..#%
%##.e%#pe.%%
%#%#####.##%
%%%.##...###
%#%#.##.####
p#%..#######
