%%%#r##e...#
#%##.#%%#pp#
#%%%%%%%%###
%%%%##%%####
....##%##r##
r##.##%%#...
#e###%%%%#e.
...###%%%%.#
##r...%##..r
###.#####...
##.e..p#X#e#
r..#..##...#
