r######.r#%%
.#.......#%.
.#....#e##%.
e#e####pp#%.
%%%%%%##e#%.
%#...%%%%%%.
%########%##
%#%%%#p.#%p#
%#%%%#..#%.#
%##%###e##.#
%%%%#%#....#
###%%%e.####
