##r..#####%%
####.#r###%%
#.r#.#%%%#%%
#e#.e%%#%%%#
p...#%%##%##
#e##%%#p#%%%
...%%##e#%#%
r.##%##.%%##
..##r#X#%r##
#ep##..#%###
#...e..#%###
######.#%%##
