p..e##.....#
###....###.r
%%%.####p.e#
%%##%#%###..
%##.%#%#%##.
%.##%%%#%%%.
%#%##%%%%#%#
%%%%#%###%%#
#.#%%%#%%%%#
.%%%.##%%.##
%%##.###%#%.
##p..#%%%%%#
