###%#..%%%%%
%%#%..#%###%
%%%%##%%%%##
##.%%%%###.p
%#..%#......
%###%%#.##e#
%%%%%%#.#..#
%###%......#
%#%%%...##.#
##%####.##..
#%%#..e.##.r
####r.######
