##%%%#####%%
####%#%###%%
#%%#%#%%%#%%
#%#%%%%#%%%#
%%%%#%%##%##
#%##%%#%#%%%
.%%%%##%#%#%
%%##%##%%%##
.%##%#%#%%##
#%%##.%#%###
#.%%%%%#%###
######.#%%##
