#####%%#####
####.#%####%
##%#%%%%%%#%
##%#%#..#%%%
##%%%#..%%..
##p.#%%%%...
r###%%#%###p
..##%###%%##
..r#%%%%%###
##..e###e###
#pe.####r###
##....######
