%%%%##%%%%%#
###%%%%###%%
%%%%####%%%#
%.##r#r###%%
.##..#.#.##%
e.##...#..%%
.#r##..e.#%#
.e..#.###%%#
#.#e..#..%.#
.e...##%%%##
p.##.###%#%.
##p..#r.%%%#
