####.#r.#.p#
%###..#.#..#
%#..#.....##
%%#...##..##
#%#..%####r#
%%#%#%%%%%e.
%%%%#%##%.#.
%##%%%#pe.X.
%#%#####.##r
%%%%##...###
%#%#.##.####
%#%..#######
