%%%#r##%...#
#%##%#%%#pp#
#%%%%%%%%###
%%%%##%%####
%%%%##%##r##
r##.##%%#.%.
#e###r%%%#%.
...###%%%%%#
##r...e##.%r
###.#####...
##.e..p#X#e#
r..#..##...#
