p#r...###%%#
.##...p#%%%#
.....e#%%%%%
#..##...#%%#
r###...##%%#
e.e..#%%%%##
#.#.#%%##%##
#r#.##%%%%##
.e.%%%%#%%%%
...######%%%
.#.#########
X.p#########
