##%%%#####%%
####%#%###%.
#.r#%#%%%#%.
#e#%%%%#%%%#
%%%%#..##%##
#%##..#%#%%%
.%...##%#%#%
%%##.##%%%##
.%##r#%#%%##
#%p##%%#%###
#%%%%%%#%###
######%#%%##
