p#r...###r.#
.##...p#...#
.....e#....r
#..##...#..#
%###...##e.#
%%%..#....##
#%#.#pe##.##
#%#.##%%%.##
%%%%%%%#%%%%
%..######%..
%#.#########
%.p#########
