#%%.e.r#####
p#%.####....
..%%#%##.##X
#.#%.%#..#r.
###%#%#.##.#
##%%%%%.##%#
%%%#.%.#..%%
#%%##%%#%%%%
##%###%%%#.#
#r###..###p#
..#.e.######
.....#######
