p#r#.p.##...
.#.#...##..r
.%.###.e....
#%###%#.####
#%##%%%%%.r#
#%%#%##%#e##
#%%%%%##...X
#%%%#%%#..##
#####%#...e.
#..%%%%%%#..
#r.#.###e#.p
#..e.#p..###
