###%#%%%....
%%#%%%#%###X
%%%%##%%%%##
##%.%%%###%%
p#%%%#%%%%%%
e###%%#.##%#
...e.%#.#%%#
e###.%....%#
r#%%%%..##%#
##%####.##%%
#%%#..e.##%%
####r.######
