.p#.#%%##.##
..#%%%%%%.##
.##%%##%%%##
%%%%#%%%%%##
%#%###%##e.#
%%###p.p#..#
%%#..#.##..#
#%#..##r..##
#%%%.....e.r
..%#....#..#
.#...#####.#
e..r...X##.p
