%######%%#.%
%#%%%%%%%#.%
%#%...#%##.%
%#%####%%#.%
%%%...##%#%%
%#......%%%.
%########%##
%#r.r#p.#%p#
%#...#..#%.#
%##e###e##.#
%%%%#%#....#
###%%%e.####
