%%%#%##%...#
#%##%#%%#pp#
#%%%%%%%%###
%%%%##%%####
%%%%##%##r##
%##.##%%#...
#e###%%%.#%.
...###p%%%%#
##r...e##%%r
###.#####%%.
##.e..p#X#%#
r..#..##...#
