#####r.#####
####%#%####r
##%#%%%%%%#r
##%#%#%%#.%%
##%%%#%%%%%%
##p.#%%%%%%%
r###%%#%###%
..##.###eX##
..r#.....###
##..e###e###
#pe.####r###
##....######
