##r..#####%%
####.#r###%%
#.r#.#...#%%
#e#.e..#.%%#
p...#..##%##
#e##..#p#%%%
.....##e#%#%
r.##.##%%%##
..##r#X#%%##
#ep##..#%###
#...e..#%###
######.#%%##
