####.#r.#.p#
r###.%#.#..#
.#..#%....##
..#.%%##..##
#.#.%%####r#
.%#%#%%%%%%.
%%%%#%##%%#.
%##%%%#p%%X.
%#r#####%##r
%%%.##..%###
e#%#.##.####
p#%%.#######
