.p#.#%%##.##
..#%%%....##
.##%.##...##
%%%%#r.e..##
%#.###.##e.#
%%###p.p#..#
.%#..#.##..#
#%#..##r..##
#%%%%....e.r
..e#%...#..#
.#%%%#####.#
%%%%%%%%##.p
