p#r#.p.##...
.#.#...##..r
.e.###.%....
#.###r#%####
#.##%%%%%%%#
#.%#%##%#%##
#.%%%%##%%.X
#.%%#..#%.##
#####.#.%%e.
#..e....%#..
#r.#.###%#.p
#..e.#p..###
