p..e##.....#
###....###.r
%%..####p.e#
%%##%#%###..
%##.%#%#.##.
%.##%%%#%%%.
%#%##%%%%#%#
%%%.#%###%%#
#%#e%%#..%.#
%%%%%##.%%##
%%##%###%#%.
##%%%#r.%%%#
