#%%.e.r#####
p#%.####....
..%%#p##.##X
#.#%..#..#r.
###%#.#.##.#
##%%%%%.##%#
%%%#..%#..%%
#%%##.%#%%%%
##%###%%%#.#
#r###..###p#
..#.e.######
.....#######
