p..e##.....#
###....###.r
.r..####p.e#
%.##r#r###..
%##..#.#.##.
%.##...#%%%.
%#%##%%%%#%#
%%%%#%###%%#
#.#%%%#..%.#
.e...##.%%##
p.##.###%#%.
##p..#%%%%%#
