###p#.......
r.#r..#.###X
..%.##..rr##
##%...e###.p
%#%%%#......
%###%%#.##e#
%%%%%%#.#..#
%###%%%....#
%#%%%%..##.#
##%####.##..
#%%#..e.##.r
####r.######
