##r..#####%%
####.#%###%%
#.r#.#%%%#%%
#e#.e%%#%%%#
p...#%%##%##
#e##%%#%#%%%
%%%%%##%#%#%
%.##%##%%%##
%%##%#%#%%##
#%p##%%#%###
#%%%%%.#%###
######.#%%##
