p#r...###%%#
.##...p#%%%#
.....e#%%.%%
#..##.%%#%%#
%###%%%##%.#
%%%%%#%%.%##
#%#.#%%##%##
#%#.##%..%##
%%..e%%#.%%%
%%.######%%%
%#.#########
%.p#########
