#%%.e.r#####
p#%.####....
..%%#%##.##%
#.#%.%#..#%%
###%#%#.##%#
##%%%%%.##%#
%%%#.%.#..%%
#%%##%%#%%%%
##%###%%%#.#
#r###..###p#
..#.e.######
.....#######
