%%%%##%%%%%#
###%%%%###.r
%%%%####p.e#
%%##r#r###..
%##..#.#.##.
%%##...#....
%#%##..e.#e#
%%%%#.###..#
#.#e..#..r.#
.e...##...##
p.##.###.#X.
##p..#r....#
