#%%%%%%#####
p#%%####....
..%%#%##.##%
#.#%%%#..#%%
###%#%#.##%#
##%%%%%.##%#
%%%#%%.#..%%
#.%##%%#%%%%
##%###%%%#.#
#r###..###p#
..#.e.######
.....#######
