###p#.%%....
r.#r..#%###X
..%.##%%rr##
##%%%%%###.p
p#%.%#%%%%..
e###%p#%##e#
...e%%#%#..#
e###%%.....#
r#%%%%%.##.#
##%####.##..
#%%#..e.##.r
####r.######
