##%%%#####%%
####%#%###%%
#%%#%#%%%#%.
#%#%%%%#%%%#
%%%%#%.##%##
#%##%%#%#%%%
%%%%%##%#%#%
%%##%##%%%##
.%##%#X#%%##
#%%##..#%###
#%%%e..#%###
######.#%%##
