%%#.#%%##.##
%%#r%%%%..##
%##%%##...##
%%%%#r.e..##
%#%###.##e.#
%%###p.p#..#
%%#..#.##..#
#%#..##r..##
#%.e.....e.r
%%%#....#..#
%#%..#####.#
%%%r...X##.p
