p#%%%%###r.#
.##%%%%#...#
...%%%#....r
#..##%%%#..#
r###.%%##e.#
e.e..#%...##
#.#.#%%##.##
#r#.##%%%%##
.e..e%%#%%%r
...######%%.
.#.#########
X.p#########
