###%#..%%%%%
r.#%..#%###%
..%%##%%%%##
##%%%%%###.p
p#.%%#......
e###%%#.##e#
%%%%%.#.#..#
%###%......#
%#%%%...##.#
##%####.##..
#%%#..e.##.r
####r.######
