##%%%#####%%
####%#%###%%
#.r#%#%%%#%%
#e#%%%%#%%%#
p..%#%%##%##
#e##%%#%#%e.
.....##%#%#r
r.##.##%%%##
..##r#X#%%##
#ep##..#%###
#...e..#%###
######.#%%##
