p#r...###r.#
.##...p#%..#
.....e#%%%%r
#..##.%%#%%#
r###.%%##%%#
e.e..#%%%%##
#.#.#p%##%##
#r#.##%%%%##
.e..e%%#%%%%
...######%%%
.#.#########
X.p#########
