#%%%%%%#####
%#%%####%...
%%%%#p##%##X
#%#%..#%%#r.
###%#.#%##.#
##%%%%%%##e#
%%%#.%%#...r
#%%##%%#e..r
##r###...#.#
#r###..###p#
..#.e.######
.....#######
