##%%%#####%%
####%#%###%%
#%%#%#%%%#%%
#%#%%%%#%%%#
%%%%#%.##%##
#%##%%#p#%%%
%%%%%##e#%#%
%%##%##..%##
.%##%#X#%%##
#%p##..#%###
#...e..#%###
######.#%%##
