p#r#.p.##...
.#.#...##..r
.e.###.e....
#.###%#%####
#.##%%%%%%%#
#.%#%##%#%##
#%%%%%##%%%X
#%%%#%%#%%##
#####%#%%%%.
#..%%%%%.#..
#r.#.###e#.p
#..e.#p..###
