p#%%..###r.#
.##%%%p#...#
.%%%.%#....r
#%%##%..#..#
r###%%%##e.#
e.e..#%%%%##
#.#.#p%##%##
#r#.##%%%%##
.e%%%%%#%%%%
...######%%%
.#.#########
X.p#########
