###p#%%%....
%%#%%%#%###X
%%%%##%%%%##
##..%%%###.p
p#..%#......
e###%%#.##e#
%%%%%.#.#..#
%###%......#
%#%%%...##.#
##%####.##..
#%%#..e.##.r
####r.######
