###%#.......
r%#%..#.###X
%%%%##..rr##
##%%%.e###.p
%#%%%#......
%###%%#.##e#
%%%%%%#%#..#
e###%%%%...#
r#%%%%%%##.#
##%####.##..
#%%#..e.##.r
####r.######
