.%%#%##%%%%#
#%##%#%%#%%#
#%%%%%%..###
%%..##%.####
%%..##%##r##
%##.##%.#...
#e###%%%%#e.
...###%%%%.#
##%%%%%##%%%
###%#####%%%
##%%%%%#%#%#
%%%#..##%%%#
