#%%%e.r#####
p#%%####....
..%%#%##.##X
#.#%%%#..#r.
###%#.#.##.#
##%%%%%.##e#
p%%#%%%#...r
#%%##%%#e..r
##%###%%.#.#
#r###%%###p#
..#.%%######
.....#######
