p#r...###r.#
.##...p#...#
.....e#....r
#..##...#..#
r###...##e.#
e.e..#....##
#.#.#%%##%##
#r#.##%%%%##
.e.%%%%#%%%%
...######%%%
.#.#########
X.p#########
