p#r...###%%#
.##...p#.%%#
.....%#%%%%r
#..##%%%#%%#
r###%%%##%%#
e.e.%#%.%%##
#.#.#p%##%##
#r#.##%.%%##
.e..%%%#%%.r
...######%%%
.#.#########
X.p#########
