.%%#%##%%%%#
#%##%#%%#%%#
#%%%%%%%.###
%%..##%%####
%...##%##r##
%##.##%.#...
#%###%%%%#e.
.%%###%%%%%#
##%%%%%##%%%
###%#####%%%
##%%%%%#%#%#
%%%#%%##%%%#
