####.#r.#.p#
%###..#.#..#
%#..#.....##
%%#...##..##
#%#%%%####r#
%%#%#%%%%%e.
%%%%#%##.%#.
%##.e%#pe%%.
%#%#####.##r
%%%.##...###
e#%#.##.####
p#%..#######
