##r..#####%%
####.#%###%%
#.r#.#%%%#%%
#e#.e.%#%%%#
p...#%%##%##
#e##%%#%#%%%
.%%%%##%#%#%
%%##%##%%%##
.%##%#X#%%##
#%p##..#%###
#...e..#%###
######.#%%##
