#%%%%%%#####
p#%%####....
..%%#%##.##%
#.#%.%#..#%%
###%#%#.##%#
##%%%%%.##%#
%%%#..%#..%%
#.%##.%#%%%%
##%###%%%#%#
#r###..###%#
..#.e.######
.....#######
