#####%%#####
####.#%####%
##%#%%%.%%#%
##%#%#%.#%%%
##%%%#%%.%%%
##p.#%%%%%%%
%###%%#%###%
%.##%###eX##
%%%#%....###
##%%%###e###
#pe.####r###
##....######
