##%%%#####%%
####%#%###%%
#%%#%#%%%#%.
#%#%%%%#%%%#
%%%%#%.##%##
#%##%%#%#%%%
%%%%%##%#%#%
%%##%##%%%##
.%##%#%#%%##
#%%##%%#%###
#.%%%%.#%###
######.#%%##
