###%#%%%%%%%
%%#%%%#%###%
.%%%##%%%%##
##.%%%%###.p
%#..%#%%....
%###%%#%##%#
%%%%%.#%#.%#
%###%%.%%%%#
%#%%%%%%##%#
##%####%##%%
#%%#%%%%##%%
####%%######
