##%%%#####%%
####%#%###%%
#%%#%#%%%#%%
#%#%%%%#%%%#
%%%%#%.##%##
#%##%%#p#%%%
%%%%%##e#%#%
%.##%##..%##
..##%#X#%%##
#ep##..#%###
#...e..#%###
######.#%%##
