##%%%#####%%
####%#%###%%
#%%#%#%%%#%%
#%#%%%%#%%%#
%%%%#%%##%##
#%##%%#%#%%%
.%%%%##%#%#%
%%##%##%%%##
.%##%#%#%%##
#%%##%%#%###
#.%%%%.#%###
######.#%%##
