#####%%#####
####.#%####%
##%#%%%%%%#%
##%#%#..#%%%
##%%%#..%%..
##p.#%%%%...
%###%%#%###p
%%##%###%%##
.%%#%%%%%###
##%%%###e###
#%%%####r###
##....######
