##r..#####.p
####.#%###..
#%%#.#%%%#..
#%#%%%%#%%.#
%%%%#..##%##
#%##..#p#%%%
%%...##e#%#%
%%##.##..%##
.%##r#X#%%##
#ep##..#%###
#...e..#%###
######.#%%##
