##r..#####.p
####.#%###..
#.r#.#%%%#..
#e#.e%%#%%.#
p...#%.##%##
#e##%%#p#%%%
....%##e#%#%
r.##%##..%##
..##%#X#%%##
#ep##..#%###
#...e..#%###
######.#%%##
