###%#%%%%%%%
%.#%%%#%###%
%%%%##%%%%##
##.%%%%###.p
%#..%#%%....
%###%%#%##e#
%%%%%.#%#..#
%###%%.%%%%#
%#%%%%%%##%#
##%####%##%%
#%%#%%%%##%%
####%%######
