.%%#%##e...#
#%##%#..#pp#
#%%%%%%..###
%%%%##%.####
%%%.##%##r##
%##.##%%#...
#e###%%%%#e.
...###%%%%%#
##r...e##.%%
###.#####.%%
##.e..p#%#%#
r..#..##%%%#
