#####r.#####
####.#e####%
##%#%%%%%%#%
##%#%#..#%%%
##%%%#%%%%%%
##p.#%%%%.%%
r###%%#%###%
..##%###%%##
..r#%%%%%###
##..e###e###
#pe.####r###
##....######
