%######.%#.%
%#%%%%%%%#.%
%#%%..#%##.%
%#%####%%#.%
%%%%%.##%#.%
%#%%%...%%%%
%########%##
%#r.r#p.#%%#
%#...#..#%%#
%##e###e##%#
%%%%#%#...%#
###%%%e.####
