##%%%#####%%
####%#%###%%
#.r#%#%%%#%%
#e#%%%%#%%%#
p...#..##%##
#e##..#%#%%%
.....##%#%#%
r.##.##%%%##
..##r#X#%%##
#ep##..#%###
#...e..#%###
######.#%%##
