#####%%#####
####.#%####%
##%#%%%%ep#%
##%#%#.%#.%%
##%%%#%%%%%%
##p.#%%%%%%%
r###%%#%###%
..##%###%%##
..r#%%%%%###
##..e###e###
#pe.####r###
##....######
