#####%%#####
####%#%####%
##%#%%%%%%#%
##%#%#%%#%%%
##%%%#%%.%%%
##%%#%%%%%%%
r###%%#%###%
..##%###%%##
..r#%%%%%###
##..e###%###
#pe.####%###
##....######
