###p#.......
r.#r..#.###X
..e.##..rr##
##....e###%%
p#...#%%%%%%
e###.p#%##%#
...e..#%#%%#
e###%%%%%%%#
r#%%%%%%##%#
##%####%##%%
#%%#%%%%##%%
####%%######
