#####%%#####
####%#%####r
##%#%%%%%%#r
##%#%#%%#%..
##%%%#%%....
##p.#%%%....
r###%%#%###p
..##%###%%##
..r#%%%%%###
##..%###e###
#pe.####r###
##....######
