r######.r#%%
.#.......#%%
.#....#e##%.
e#e####pp#%%
......##e#%%
r#.......%%.
.########%##
.#r.r#p.#%%#
.#...#..#%%#
r##e###e##%#
....#%#%%%%#
###..%%%####
