%#%#.p.##...
%#%#...##..r
%%%###.%....
#%###r#%####
#%##%%%%%%r#
#%%#%##%#%##
#%%%%%##.%%%
#..%#..#..##
#####.#...e.
#..e.....#..
#r.#.###e#.p
#..e.#p..###
