r######%%#.%
.#.%%%%%.#.%
.#%%%%#%##.%
e#%####%%#%%
%%%...##%#%.
%#......%%%.
%########e##
%#r.r#p.#.p#
%#...#..#r.#
%##%###e##.#
%%%%#%#....#
###%%%e.####
