#####%%#####
####.#%####%
##%#%%%%%%#%
##%#%#..#%%%
##%%%#%%%%%.
##p.#%%%%%%%
r###%%#%###%
..##%###%%##
..r#%%%%%###
##..e###%###
#pe.####%###
##....######
