#####%%#####
####%#%####%
##%#%%%%%%#%
##%#%#%.#%%%
##%%%#%%%%%%
##%%#%%%.%%%
r###%%#%###%
..##%###%%##
..r#%%%%%###
##..e###%###
#pe.####%###
##....######
