##r..#####%%
####.#%###%%
#.r#.#%%%#%%
#e#.e%%#%%%#
p...#%%##%##
#e##%%#%#%%%
.%%%%##%#%#%
r%##%##%%%##
..##%#X#%%##
#ep##..#%###
#...e..#%###
######.#%%##
