p#r#.p.##...
.#.#...##..r
.e.###.e....
#.###r#.####
#.##....e.r#
#.%#%##r#e##
#%%%%%##.%%%
#%%%#%.#.%##
#####%#%%%%.
#..e%%%%.#..
#r.#.###e#.p
#..e.#p..###
