###%#..%%%%%
%.#%..#%###%
%%%%##%%%%##
##%%%%%###%%
%#%%%#%%%%%%
%###%%#%##%#
%%%%%%#%#%%#
%###%%.%%%%#
%#%%%%%.##%#
##%####.##%%
#%%#..e.##%%
####r.######
