###p#..%%%%%
r.#r..#%###%
..e.##%%rr##
##....%###.%
p#...#%%%%%%
e###.p#%##%#
...e.%#%#%%#
e###.%%%%%%#
r#%%%%%%##%#
##%####%##%%
#%%#..e%##%%
####r.######
